type octile
height 18
width 19
map
@@@@......@@@..@@@@
@@@@.....E@@@E.@@@@
@@@@......@@@..@@@@
@@@@...........@@@@
...................
.E.................
@@@................
@@@.....SSS........
@@@....S@@@S.....E.
.E.....S@@@S....@@@
........SSS.....@@@
................@@@
.................E.
...................
@@@@...........@@@@
@@@@..@@@......@@@@
@@@@.E@@@E.....@@@@
@@@@..@@@......@@@@
