type octile
height 24
width 31
map
@@@@....@@@....@@@....@@@..@@@@
@@@@...E@@@E..E@@@E..E@@@E.@@@@
@@@@....@@@....@@@....@@@..@@@@
@@@@.......................@@@@
...............................
.E.............................
@@@............................
@@@.....SSS.SSS.SSS.SSS......E.
@@@....S@@@S@@@S@@@S@@@S....@@@
.E.....S@@@S@@@S@@@S@@@S....@@@
........SSS.SSS.SSS.SSS.....@@@
.......S@@@S@@@S@@@S@@@S.....E.
.E.....S@@@S@@@S@@@S@@@S.......
@@@.....SSS.SSS.SSS.SSS........
@@@....S@@@S@@@S@@@S@@@S.....E.
@@@....S@@@S@@@S@@@S@@@S....@@@
.E......SSS.SSS.SSS.SSS.....@@@
............................@@@
.............................E.
...............................
@@@@.......................@@@@
@@@@..@@@....@@@....@@@....@@@@
@@@@.E@@@E..E@@@E..E@@@E...@@@@
@@@@..@@@....@@@....@@@....@@@@
